#..................#
....############....
....#..........#....
....#..........#....
....#..........#....
....................
....................
....................
....................
....................
....................
....................
....................
....................
....................
....#..........#....
....#..........#....
....#..........#....
....############....
#..................##